////////////////////
/                  /
/       @          /
/                  /
/                  /
/   E              /
/                  /
/             E    /
/                  /
////////    ////////
/                  /
/                  /
/                  /
/                  /
/    E             /
/                  /
/                  /
/            E     /
/                  /
/////////#//////////