////////////////////
/                  /
/       @          /
/                  /
/                  /
/  %               /
/                  /
/             %    /
/                  /
////////    ////////
/                  /
/                  /
/                  /
/                  /
/    %             /
/                  /
/                  /
/            %     /
/                  /
/////////#//////////